-1 -1 -1 -1 -1 -1 -1 0 -1 -1 -1 -1 -1 -1 -1 -1
-1 0 0 -1 0 0 -1 0 -1 -1 5 0 0 0 0 -1
-1 0 0 -1 0 0 -1 0 -1 0 0 -1 0 -1 0 -1
-1 -1 13 0 0 0 -1 0 -1 0 0 -1 0 -1 0 -1
-1 14 0 0 -1 10 -1 0 -1 0 0 -1 0 -1 0 -1
-1 0 0 0 -1 0 0 8 0 0 5 -1 0 -1 0 -1
-1 0 0 0 -1 -1 -1 -1 -1 -1 0 -1 0 -1 0 -1
-1 0 0 0 -1 10 0 0 0 -1 0 -1 0 -1 0 -1
-1 0 -1 -1 -1 0 0 -1 0 -1 0 -1 0 -1 0 -1
-1 0 0 0 -1 0 0 -1 0 -1 0 -1 0 -1 0 -1
-1 0 0 0 -1 0 0 -1 0 -1 0 -1 0 2 0 -1
-1 0 0 0 -1 0 9 0 7 0 0 -1 3 0 0 -1
-1 14 0 0 -1 0 0 0 0 0 -1 -1 0 0 0 -1
-1 0 0 0 0 0 0 0 0 6 0 0 0 -1 1 -1
-1 0 0 0 0 0 9 -1 0 0 0 0 0 0 0 -1
-1 -1 -1 -1 -1 -1 -1 -1 -1 -1 -1 -1 -1 -1 -1 
